11111111111111111111111111111
10101000001111011111100000001
10100000000011111111111111001
10101000011111110000000000001
10101000000111111100000000001
10101000011110000000111100001
10001000001000000000000000001
10001000000000111111111111111
11111111110000000000000000001
10000000011111111111111000001
11111111111111111111111111111